

NO ./test.xpm

NO ./parsing/parsing.c.xpm
C 225,30,0

NO    '     '

SO ./path_to_the_south_texture

WE ./path_to_the_west_texture

F 220,100,25

EA ./path_to_the_east_texture



111111111111111111111111111
1000000000110000000000001
101100000111000000000001
1001000000000000000000001
11111111101100000111000001111111
1000000000110000011101111111110011111
11110111111111011100000010001111
11110111111111011101010010001
11000000110101011100000010001
1111111111111111111111111111111


111111111111111111111111111111
1000p000000000001100000010001
1000000000000p001101010010001
11111111 1111111 111111111111
11111111 1111111 1111111111111
11000001110101011111011110N01111
11110111 1110101 101111010001
11111111 1111111 1111111111
11111111 1111111 111111111111
 