NO ./textures/test.xpm
SO ./textures/test.xpm
WE ./textures/test.xpm
EA ./textures/test.xpm

F 200,100,0
C 225,30,255



1111111111111111111111111
1011000001110000000000001
1000000000110000000000001
10010000000000000N0000001
1111111110110000011100001
1000000000110000011101111
1111011111111101110000001
1111011111111101110101001
1111111111111111111111111