NO ./textures/1.xpm
SO ./textures/1.xpm
WE ./textures/1.xpm
EA ./textures/1.xpm


F 120,24,74
C 224,176,255

1111111111111111111111111
1000001000110000000000001
1000010001110001000000001
100100000000001000000000111111
100000000010010000000000000001
100000000100001000000000000001
110000000000000000000000010001
100000010000000011000000100001
10000000000000001101010010001
11111111111111111111111111111
1111111111111111111111111
1000001000110000000000001
1000010001110001000000001
100100000000001000000000111111
100000000010010000000000000001
100000000100001000000000000W01
110000000000000000000000010001
100000010000000011000000100001
10000000000000001101010010001
11111111111111111111111111111