NO ./textures/test.xpm
SO ./textures/test.xpm
WE ./textures/test.xpm
EA ./textures/test.xpm


F 200,100,0
C 225,30,255

1111111111111111111111111
1000001000110000000000001
1W00010001110001000000001
100100000000000000000000111111
100000000000000000000000000001
100000000000000000000000000001
110000000000000000000000010001
100000000000000000000000100001
10000000000000001101010010001
11111111111111111111111111111